..................
..................
......O.O.........
....OO.OOO........
...OO.OOOOO.......
....OO.OOO........
......O.O.........
..................
..................

