...........................
...........................
...........................
...........OO..............
.........OOOOO.............
........OOOO.OO............
.........OOOOO.............
..........OO...............
...........................
...........................
...........................
